11111111111111111111
10000000000000000001
10000000000000000001
10011110000000000001
10000000000000000001
10000000000000004001
10011110000000000001
10000000000000000001
10000000300000000001
10000000300000000001
10000000300000000001
10000000000000000001
10000000000000000001
10011110000000000001
10000000000000000001
10000000000000000001
10011110000000000001
10000000000000000001
10000000000000000031
11111111111111111111